.....#.....
.....#.....
.....#.....
...........
.....#.....
.....#.....
.....#.....
...........
.....#.....
.....######
..........#
..........#
..........#
#####..####
#..........
#..........
#..........
#..........
######.....
.....#.....
cmds:
left,right,right,up,left,left,right,up,up