.....#.....
.....#.....
.....###...
.......#...
.......#...
.......#...
...........
.......#...
.......#...
.......####
..........#
..........#
..........#
..........#
.....######
.....#.....
.....#.....
.....#.....
.....#.....
.....#.....
cmds:
right,left,left,right,up,left,right