.....#.....
.....#.....
.....#.....
.....#.....
.....#.....
.....#.....
...........
.....#.....
.....#.....
.....######
..........#
..........#
..........#
..........#
.....######
.....#.....
.....#.....
.....#.....
.....#.....
.....#.....
cmds:
right,left,left,right,up