.....#.....
..####.....
..#........
..#........
..#........
..####.....
.....#.....
...........
.....#.....
.....##....
.....##....
.....#.....
.....#.....
######.....
#..........
#..........
#..........
#..........
######.....
.....#.....
cmds:
left,right,right,left,right,left,left,right,up,left,right,right,left