.....#.....
.....######
..........#
..........#
..........#
..........#
###########
#..........
#..........
#..........
###########
..........#
..........#
..........#
###########
#..........
#..........
#..........
######.....
.....#.....
cmds:
left,right,right,left,left,right,right,left,left,right