.....#.....
.....##..##
..........#
...........
...........
..........#
####..#####
...........
...........
#..........
#####..####
...........
...........
..........#
#####..####
...........
...........
#..........
##..##.....
.....#.....
cmds:
left,up,right,up,right,up,left,up,left,up,right,up,right,up,left,up,left,up,right