.....#.....
..####.....
...........
...........
..#........
..####.....
.....#.....
...........
.....#.....
.....##....
.....##....
.....#.....
.....#.....
######.....
#..........
##.........
##.........
#..........
######.....
.....#.....
cmds:
left,right,right,left,left,right,right,left,right,left,left,right,up,left,right,up,right,left