.....#.....
..####.....
...........
...........
..#........
..####.....
.....#.....
...........
.....#.....
.....##....
.....##....
.....#.....
.....#.....
##..##.....
#..........
...........
...........
#..........
######.....
.....#.....
cmds:
left,right,up,right,up,left,right,left,left,right,up,left,right,up,right,left