{
	"levels" :
	[
		{
			"name" : "level-00",
			"style" : "Hazb",
			"cmds" : ["run"],
			"map" : [
					".....#.....",
					".....#.....",
					".....#.....",
					".....#.....",
					".....#.....",
					".....#.....",
					".....#.....",
					".....#.....",
					".....#.....",
					".....#.....",
					".....#.....",
					".....#.....",
					".....#.....",
					".....#.....",
					".....#.....",
					".....#.....",
					".....#.....",
					".....#.....",
					".....#.....",
					".....#....."
			]
		},
		{
			"name" : "level-01",
			"style" : "Hazb",
			"cmds" : ["left", "right", "left", "right", "right", "left", "up"],
			"map" : [
					".....#.....",
					".....#.....",
					".....#.....",
					".....#.....",
					".....#.....",
					".....#.....",
					"...........",
					".....#.....",
					".....#.....",
					".....#.....",
					"######.....",
					"#..........",
					"#..........",
					"#..........",
					"###........",
					"..#........",
					"..#........",
					"..####.....",
					".....#.....",
					".....#....."
			]
		},
		{
			"name" : "level-02",
			"style" : "Hazb",
			"cmds" : ["right","left","left","right","up","left","right"],
			"map" : [
					".....#.....",
					".....#.....",
					".....###...",
					".......#...",
					".......#...",
					".......#...",
					"...........",
					".......#...",
					".......#...",
					".......####",
					"..........#",
					"..........#",
					"..........#",
					"..........#",
					".....######",
					".....#.....",
					".....#.....",
					".....#.....",
					".....#.....",
					".....#....."
			]
		},
		{
			"name" : "level-03",
			"style" : "Hazb",
			"cmds" : ["right","left","left","right","up"],
			"map" : [
					".....#.....",
					".....#.....",
					".....#.....",
					".....#.....",
					".....#.....",
					".....#.....",
					"...........",
					".....#.....",
					".....#.....",
					".....######",
					"..........#",
					"..........#",
					"..........#",
					"..........#",
					".....######",
					".....#.....",
					".....#.....",
					".....#.....",
					".....#.....",
					".....#....."
			]
		},
		{
			"name" : "level-04",
			"style" : "Hazb",
			"cmds" : ["left","right","right","up","left","left","right","up","left","right","right","left"],
			"map" : [
					".....#.....",
					"..####.....",
					"..#........",
					"..#........",
					"..####.....",
					".....#.....",
					"...........",
					".....#.....",
					".....#.....",
					".....######",
					"..........#",
					"####.######",
					"#..........",
					"#..........",
					"######.....",
					".....#.....",
					".....#.....",
					".....#.....",
					".....#.....",
					".....#....."
			]
		},
		{
			"name" : "level-05",
			"style" : "Hazb",
			"cmds" : ["left","right","left","right","right","up","left","left","right","up"],
			"map" : [
					".....#.....",
					".....#.....",
					".....#.....",
					"...........",
					".....#.....",
					".....#.....",
					".....#.....",
					".....#.....",
					".....#.....",
					".....######",
					"..........#",
					"..........#",
					"..........#",
					"######.####",
					"#..........",
					"#..........",
					"###........",
					"..#........",
					"..####.....",
					".....#....."
			]
		},
		{
			"name" : "level-06",
			"style" : "Oush",
			"cmds" : ["left","right","right","up","left","left","right","up","up"],
			"map" : [
					".....#.....",
					".....#.....",
					".....#.....",
					"...........",
					".....#.....",
					".....#.....",
					".....#.....",
					"...........",
					".....#.....",
					".....######",
					"..........#",
					"..........#",
					"..........#",
					"#####..####",
					"#..........",
					"#..........",
					"#..........",
					"#..........",
					"######.....",
					".....#....."
			]
		},
		{
			"name" : "level-07",
			"style" : "Oush",
			"cmds" : ["left","right","right","left","right","left","left","right","up","left","right","right","left"],
			"map" : [
					".....#.....",
					"..####.....",
					"..#........",
					"..#........",
					"..#........",
					"..####.....",
					".....#.....",
					"...........",
					".....#.....",
					".....##....",
					".....##....",
					".....#.....",
					".....#.....",
					"######.....",
					"#..........",
					"#..........",
					"#..........",
					"#..........",
					"######.....",
					".....#....."
			]
		},
		{
			"name" : "level-08",
			"style" : "Oush",
			"cmds" : ["left","right","up","right","up","left","right","left","left","right","up","left","right","up","right","left"],
			"map" : [
					".....#.....",
					"..####.....",
					"...........",
					"...........",
					"..#........",
					"..####.....",
					".....#.....",
					"...........",
					".....#.....",
					".....##....",
					".....##....",
					".....#.....",
					".....#.....",
					"##..##.....",
					"#..........",
					"...........",
					"...........",
					"#..........",
					"######.....",
					".....#....."
			]
		},
		{
			"name" : "level-09",
			"style" : "Oush",
			"cmds" : ["left","right","right","left","left","right","right","up","left","right","left","left","right","up","left","right","up","right","left"],
			"map" : [
					".....#.....",
					"..####.....",
					"...........",
					"...........",
					"..#........",
					"..####.....",
					".....#.....",
					"...........",
					".....#.....",
					".....##....",
					".....##....",
					".....#.....",
					".....#.....",
					"##..##.....",
					"#..........",
					"##.........",
					"##.........",
					"#..........",
					"######.....",
					".....#....."
			]
		},
		{
			"name" : "level-10",
			"style" : "Oush",
			"cmds" : ["left","right","right","left","left","right","right","left","left","right"],
			"map" : [
					".....#.....",
					".....######",
					"..........#",
					"..........#",
					"..........#",
					"..........#",
					"###########",
					"#..........",
					"#..........",
					"#..........",
					"###########",
					"..........#",
					"..........#",
					"..........#",
					"###########",
					"#..........",
					"#..........",
					"#..........",
					"######.....",
					".....#....."
			]
		}
	]

}